-E--------------------------------------
|   |                           ☺      |
|                T                     |
|                                      |
|----                           -------|
|////|                          |     §|
|----                           >      |
|           T                   |    T |
|☺                              -------|
|                      T               |
|                                      |
--------------------------------X-------