------------------------------------X---
|          φ             T             |
|                                      |
|                                    φ |
E          T                    -------|
|                               |//////|
|-----                          |//////|
|////|                          -------|
|////|                 T        |       
|--------------------------------        
