-E--------------------------------------
|   |                           T      |
|                                      |
|                 φ                    |
|----                           -------|
|////|                          |     §|
|----                           >      |
|           T                   |    T |
|                               -------|
|  φ                                   |
|                                      |
--------------------------------X-------