-E------------------------------        
|                               |       
|               T               |------|
|       φ                       |//////|
|----          ------           |//////|
|§  |          |////|           |//////|
|   |          ------           -------|
|^---                                  |
|                      φ             --|
| T                                 |   
--------------------------------X----    