----------------------------------------
E                φ             T|//////|
|-----                          |//////|
|////|                          |//////|
|////|              T           |//////|
|////|                          -------|
|////|                                 |
|////|T                φ         T     |
|////|                                 |
--------------------------------X-------